,amount,balance,oppositeAccount,oppositeAccountName,time,type
0,10,30005,8173448813031303082,个人账户4500,2019-01-01 03:46:48,消费
1,418,30423,4435873553164166751,对公账户2712,2019-01-01 12:10:04,消费
2,5370,35793,2231186114807048470,对公账户3781,2019-01-02 07:01:55,消费
3,32,35825,2760530232530051310,个人账户4135,2019-01-02 08:00:14,消费
4,145,35970,5150723151171825138,对公账户0275,2019-01-02 08:56:24,消费
5,15,35985,3788455575676646137,个人账户0720,2019-01-02 18:11:31,消费
6,41,36026,4628127456536286746,个人账户7502,2019-01-03 06:58:19,消费
7,3812,39838,7611642317557366550,对公账户3384,2019-01-03 21:33:07,消费
